111111111111
10000001X011
1P0000010011
10C0C0C00011
10000C01C011
1000C0C11111
1C1000000011
111000000011
100000000E11
111111111111