111111
100111
1PC1E1
100101
111111