1111111111
1P000000E1
1000C000X1
1111111111