1111111111111111111111111111111111111111
100P000000000000000000000000000000000001
1000000000000000000000000000000000000001
1000000000000000000000000000000000000001
1000000000000000000000000000000000000001
1000000000000000000000000000000000000001
1000000000000000000000000000000000000001
1000000000000000000000000000000000000001
1000000000000000000000000000000000000001
100000000000000C000000000000000000000001
1000000000000000000000000000000000000001
1000000000000000000000000000000000000001
100000000000000C000000000000000000000001
1000000000000000000000000000000000000001
1000000000000000000000000000000000000001
100000000000000C000000000000000000000001
1000000000000000000000000000000000000001
1000000000000000000000000000000000000001
100000000000000C000000000000000000000001
1000000000000000000000000000000000000001
1000000000000000000000000000000000000001
1000000000000000000000000000000000000001
1000000000000000000000000000000000000001
1000000000000000000000000000000000000001
1000000000000000000000000000000000000001
1000000000000000000000000000000000000001
1000000000000000000000000000000000000001
100000000000000000000000000000000000E001
1000000000000000000000000000000000000001
1111111111111111111111111111111111111111
