1111111111111111111111111
100000000000X000000000001
1000000000000000000000001
100C00010000000001000C001
1000000100000000010000001
1000000000000000000000001
1000110000000000000110001
100000000000P000000000001
1000110000000000000110001
1000000000000000000000001
1000000100000000010000001
100000010000000001000C001
100C00000000E000000000001
1000000000000000000000001
1111111111111111111111111
